........................#...........
......................#.#...........
............##......##............##
...........#...#....##............##
##........#.....#...##..............
##........#...#.##....#.#...........
..........#.....#.......#...........
...........#...#....................
............##......................