########
........
........
........
........
...#....
...#....
...#....
........
........
........
........
...###..
........
........
........
........
...##...
..#..#..
..#..#..
...##...