...##.....
...##.....
..........
..........
..........
...##.....
...#.#....
....#.....
..........
..........
....##....
...#..#...
...#.#....
....#.....
..........
..........
....#.....
...#.#....
...#.#....
....#.....
..........
..........
....#.....
...#.#....
....#.....
..........
..........
..........
..........
.....##...
....#..#..
....#..#..
.....##...
..........
..........